{
  "cells": [
    [9,0,0,0,0,0,0,0],
    [1,10,9,0,0,0,0,0],
    [1,2,1,2,0,0,0,0],
    [0,0,0,0,0,0,0,0],
    [0,0,0,0,0,0,0,0],
    [0,0,0,0,0,0,0,0],
    [0,0,0,0,0,0,0,0],
    [0,0,0,0,0,0,0,0]
  ],
  "level": 0,
  "startRow": 2,
  "startCol": 1,
  "startDirection": "north",
  "startHeight": 2
}
